  XXXXXX XXXXXX
  X    X      X
  X     X     X
  X      X    X
  X   X   X   X
  X   X   X   X
  X   X   X   X
XXX   X       X
X     X       X
X O   XXXXXXXXX
X     X
XXXXXXX
