XXXXXXXXXXxXXXXXXXxXXXXXXX
X        X X     X H     X
XHX    XXXHXXXXXXXHXXXXHHX
  H    H       X      H  X
XHX    X   X      X   XK X
XXXXXXXXXXXXXXXXXXXXXXXXXX
